0010101100101
1001010111101
1000000000011
1011101111111
1111100000000
